1111111
1000E11
1P00001
100C001
1111111
