111111111
10000C001
1000E00C1
1000P0001
10000C001
111111111
